17 16
++++++++o++++++++
+**.....@***....+
+*.......**.....+
+****.***...*...+
+******..**...*.+
+**...***......*+
+**...JJJJJ.*...+
+*...J...**J...*+
+.*..J*.N..J**.*+
+**..J..k*.J.*.*+
+*.*..JJJJJ***..+
+.****...**..**.+
+*........*..***+
+..***..*.**...*+
+.*pC...*.*...*.+
++++++++A++++++++