17 16
++++++++o++++++++
+**.....@***....+
+*.......**.....+
+****.***...*...+
+******..**...*.+
+**...***......*+
+**.....**..*...+
+*.......**....*+
+.*.***.B...**.*+
+**.**...*...*.*+
+*.*...*...***..+
+.****...**..**.+
+*........*..***+
+*.***..*.**...*+
+lpz....*.*...*.+
+++++++++++++++++