17 16
++++++++o++++++++
+**.....@***....+
+*.......**.....+
+****.***...*...+
+******..**...*.+
+**...***......*+
+**.....**..*...+
+*.......**....*+
+.*.***.B...**.*+
+**.**..k*...*.*+
+*.*...*...***..+
+.****...**..**.+
+*........*..***+
+*.***..*.**...*+
+lpz....*.*...*.+
++++++++A++++++++